9113951393
EAAC03A86A
96C3E86C52
C3FAFAFFFA
BAFEF857FA
86FFFAFFFA
8113FAFD56
AAAAFAFFFB
A82C3C5396
C6C7C57C47

1,1
1,9
